{
    "72": 0,
    "65": 1,
    "71": 2,
    "79": 3,
    "r": 4,
    "52": 5,
    "51": 6,
    "57": 7,
    "68": 8,
    "70": 9,
    "58": 10,
    "69": 11,
    "55": 12,
    "74": 13,
    "61": 14,
    "47": 15,
    "63": 16,
    "62": 17,
    "75": 18,
    "67": 19,
    "73": 20,
    "66": 21,
    "59": 22,
    "81": 23,
    "/": 24,
    "76": 25,
    "78": 26,
    "80": 27,
    "45": 28,
    "60": 29,
    "48": 30,
    "54": 31,
    "64": 32,
    "50": 33,
    "77": 34,
    "56": 35,
    "53": 36,
    "_": 37
}